########
#  #.  #
# $#   #
#  # @##
#  # $##
#    .##
########