########
#      #
#  $  .#
#@ $  .#
#  $  .#
#      #
########